About W3C Standards--->data/html/About W3C Standards.htm
Accessibility - W3C--->data/html/Accessibility - W3C.htm
Accessible Rich Internet Applications (WAI-ARIA) 1.0--->data/html/Accessible Rich Internet Applications (WAI-ARIA) 1.0.htm
All Standards and Drafts - W3C--->data/html/All Standards and Drafts - W3C.htm
Architecture Principles - W3C--->data/html/Architecture Principles - W3C.htm
Audio and Video - W3C--->data/html/Audio and Video - W3C.htm
Authoring Tools and Social Media - W3C--->data/html/Authoring Tools and Social Media - W3C.htm
Best practices for creating MMI Modality Components--->data/html/Best practices for creating MMI Modality Components.htm
Best Practices for Publishing Linked Data--->data/html/Best Practices for Publishing Linked Data.htm
Browsers and Authoring Tools - W3C--->data/html/Browsers and Authoring Tools - W3C.htm
Browsers and Media Players- W3C--->data/html/Browsers and Media Players- W3C.htm
CC/PP Implementors Guide: Privacy and Protocols--->data/html/CC PP Implementors Guide  Privacy and Protocols.htm
Component Extension (CX) API requirements Version 1.0--->data/html/Component Extension (CX) API requirements Version 1.0.htm
Components - W3C--->data/html/Components - W3C.htm
Composite Capabilities/Preference Profiles: Terminology and Abbreviations--->data/html/Composite Capabilities Preference Profiles  Terminology and Abbreviations.htm
Composite Capability/Preference Profiles (CC/PP): Structure and Vocabularies 1.0--->data/html/Composite Capability Preference Profiles (CC PP)  Structure and Vocabularies 1.0.htm
Cross-Origin Resource Sharing--->data/html/Cross-Origin Resource Sharing.htm
CSS Namespaces Module Level 3--->data/html/CSS Namespaces Module Level 3.htm
CSS3 module: Presentation Levels--->data/html/CSS3 module  Presentation Levels.htm
Data - W3C--->data/html/Data - W3C.htm
Defining N-ary Relations on the Semantic Web--->data/html/Defining N-ary Relations on the Semantic Web.htm
Design of HTTP-NG Testbed--->data/html/Design of HTTP-NG Testbed.htm
Device APIs Requirements--->data/html/Device APIs Requirements.htm
Device Independence and Content Adaptation - W3C--->data/html/Device Independence and Content Adaptation - W3C.htm
Graphics - W3C--->data/html/Graphics - W3C.htm
Guidelines for Web Content Transformation Proxies 1.0--->data/html/Guidelines for Web Content Transformation Proxies 1.0.htm
HTML & CSS - W3C--->data/html/HTML & CSS - W3C.htm
HTML Imports--->data/html/HTML Imports.htm
HTML Templates--->data/html/HTML Templates.htm
HTTP-NG Binary Wire Protocol--->data/html/HTTP-NG Binary Wire Protocol.htm
Identifiers - W3C--->data/html/Identifiers - W3C.htm
Inference - W3C--->data/html/Inference - W3C.htm
Internationalization - W3C--->data/html/Internationalization - W3C.htm
JavaScript Web APIs - W3C--->data/html/JavaScript Web APIs - W3C.htm
LBase: Semantics for Languages of the Semantic Web--->data/html/LBase  Semantics for Languages of the Semantic Web.htm
Legacy extended IRIs for XML resource identification--->data/html/Legacy extended IRIs for XML resource identification.htm
Linked Data Glossary--->data/html/Linked Data Glossary.htm
MBUI - Task Models--->data/html/MBUI - Task Models.htm
Meta Formats - W3C--->data/html/Meta Formats - W3C.htm
Metadata API for Media Resources 1.0--->data/html/Metadata API for Media Resources 1.0.htm
Mobile Web - W3C--->data/html/Mobile Web - W3C.htm
Mobile Web Application Best Practices--->data/html/Mobile Web Application Best Practices.htm
Multimodal Access - W3C--->data/html/Multimodal Access - W3C.htm
Offline Web Applications--->data/html/Offline Web Applications.htm
Ontologies - W3C--->data/html/Ontologies - W3C.htm
OWL 2 RL in RIF (Second Edition)--->data/html/OWL 2 RL in RIF (Second Edition).htm
OWL 2 Web Ontology Language Direct Semantics (Second Edition)--->data/html/OWL 2 Web Ontology Language Direct Semantics (Second Edition).htm
OWL 2 Web Ontology Language Mapping to RDF Graphs (Second Edition)--->data/html/OWL 2 Web Ontology Language Mapping to RDF Graphs (Second Edition).htm
OWL 2 Web Ontology Language New Features and Rationale (Second Edition)--->data/html/OWL 2 Web Ontology Language New Features and Rationale (Second Edition).htm
OWL 2 Web Ontology Language RDF-Based Semantics (Second Edition)--->data/html/OWL 2 Web Ontology Language RDF-Based Semantics (Second Edition).htm
OWL 2 Web Ontology Language XML Serialization (Second Edition)--->data/html/OWL 2 Web Ontology Language XML Serialization (Second Edition).htm
OWL Web Ontology Language Overview--->data/html/OWL Web Ontology Language Overview.htm
PEP - an Extension Mechanism for HTTP--->data/html/PEP - an Extension Mechanism for HTTP.htm
Permissions for Device API Access--->data/html/Permissions for Device API Access.htm
Privacy - W3C--->data/html/Privacy - W3C.htm
Processing - W3C--->data/html/Processing - W3C.htm
Protocols - W3C--->data/html/Protocols - W3C.htm
Publishing - W3C--->data/html/Publishing - W3C.htm
Query - W3C--->data/html/Query - W3C.htm
RDF 1.1 Turtle--->data/html/RDF 1.1 Turtle.htm
Representing Classes As Property Values on the Semantic Web--->data/html/Representing Classes As Property Values on the Semantic Web.htm
Representing Specified Values in OWL: "value partitions" and "value sets"--->data/html/Representing Specified Values in OWL   value partitions  and  value sets .htm
Roadmap for Accessible Rich Internet Applications (WAI-ARIA Roadmap)--->data/html/Roadmap for Accessible Rich Internet Applications (WAI-ARIA Roadmap).htm
Role Attribute 1.0--->data/html/Role Attribute 1.0.htm
Schema - W3C--->data/html/Schema - W3C.htm
Security - W3C--->data/html/Security - W3C.htm
Semantic Web - W3C--->data/html/Semantic Web - W3C.htm
Service Description - W3C--->data/html/Service Description - W3C.htm
Subresource Integrity--->data/html/Subresource Integrity.htm
Techniques for User Agent Accessibility Guidelines 1.0--->data/html/Techniques for User Agent Accessibility Guidelines 1.0.htm
Terms for describing people--->data/html/Terms for describing people.htm
The ILU Requestor for HTTP servers--->data/html/The ILU Requestor for HTTP servers.htm
The RDF Data Cube Vocabulary--->data/html/The RDF Data Cube Vocabulary.htm
The WebSocket API--->data/html/The WebSocket API.htm
Tracking Compliance and Scope--->data/html/Tracking Compliance and Scope.htm
Transformation - W3C--->data/html/Transformation - W3C.htm
Vertical Applications - W3C--->data/html/Vertical Applications - W3C.htm
Vocabularies for EmotionML--->data/html/Vocabularies for EmotionML.htm
Voice Browsing - W3C--->data/html/Voice Browsing - W3C.htm
W3C activities related to Electronic Commerce--->data/html/W3C activities related to Electronic Commerce.htm
W3C WD: SMUX Protocol Specification--->data/html/W3C WD  SMUX Protocol Specification.htm
WAI-ARIA 1.0 Authoring Practices--->data/html/WAI-ARIA 1.0 Authoring Practices.htm
Web and TV - W3C--->data/html/Web and TV - W3C.htm
Web Architecture - W3C--->data/html/Web Architecture - W3C.htm
Web Audio Processing: Use Cases and Requirements--->data/html/Web Audio Processing  Use Cases and Requirements.htm
Web Design and Applications - W3C--->data/html/Web Design and Applications - W3C.htm
Web MIDI API--->data/html/Web MIDI API.htm
Web of Devices - W3C--->data/html/Web of Devices - W3C.htm
Web of Services - W3C--->data/html/Web of Services - W3C.htm
Web Security Context: User Interface Guidelines--->data/html/Web Security Context  User Interface Guidelines.htm
Web Services Architecture--->data/html/Web Services Architecture.htm
Web Services Policy 1.5 - Framework--->data/html/Web Services Policy 1.5 - Framework.htm
World Wide Web Consortium (W3C)--->data/html/World Wide Web Consortium (W3C).htm
XHTMLâ„¢ Basic 1.1 - Second Edition--->data/html/XHTML Basic 1.1 - Second Edition.htm
XML Essentials - W3C--->data/html/XML Essentials - W3C.htm
XML Linking Language (XLink) Version 1.1--->data/html/XML Linking Language (XLink) Version 1.1.htm
XML Schema Datatypes in RDF and OWL--->data/html/XML Schema Datatypes in RDF and OWL.htm
XML Signature Syntax and Processing Version 1.1--->data/html/XML Signature Syntax and Processing Version 1.1.htm
XML Technology - W3C--->data/html/XML Technology - W3C.htm
XMLHttpRequest Level 1--->data/html/XMLHttpRequest Level 1.htm
XPath and XQuery Functions and Operators 3.0--->data/html/XPath and XQuery Functions and Operators 3.0.htm

